NOC,Gold,Silver,Bronze,Total,Year
CAN,14,7,5,26,2010
GER,10,13,7,30,2010
USA,9,15,13,37,2010
NOR,9,8,6,23,2010
KOR,6,6,2,14,2010
SUI,6,0,3,9,2010
CHN,5,2,4,11,2010
SWE,5,2,4,11,2010
AUT,4,6,6,16,2010
NED,4,1,3,8,2010
RUS,3,5,7,15,2010
FRA,2,3,6,11,2010
AUS,2,1,0,3,2010
CZE,2,0,4,6,2010
POL,1,3,2,6,2010
ITA,1,1,3,5,2010
BLR,1,1,1,3,2010
SVK,1,1,1,3,2010
GBR,1,0,0,1,2010
JPN,0,3,2,5,2010
SLO,0,2,1,3,2010
CRO,0,2,1,3,2010
LAT,0,2,0,2,2010
FIN,0,1,4,5,2010
KAZ,0,1,0,1,2010
EST,0,1,0,1,2010
